
NO textures/no.xpm
EA textures/ea.xpm
WE textures/we.xpm
C 51,198,227
SO textures/so.xpm
F 184,113,39


11111111111        1111
10000000001        1001
10000000001111111111001
10000000000000000000001
10000111000000111000001
10000101000000101000001
10000111000000111000001
100000000000000000000S1
11111111111111111111111
