
NO textures/no.xpm





EA textures/ea.xpm
WE        textures/we.xpm
C 51,198,227


SO              textures/so.xpm
F 184,113,39


11111111111        1111
10000000001        1001


10000000001111111111001
10000000000000000000001
10000111000000111000001            111
100001 10000001 10000N1            101

10000111000000111000001            111
10000000000000000000001
11111111111111111111111
