
NO textures/no.xpm
EA textures/ea.xpm
F 184,113,39
SO textures/so.xpm
WE textures/we.xpm

C 51,198,227

1111    1111
N00111111001
100000000001
111000000111
  10000001
  10000001
111000000111
100000000001
100111111111
1111